1111111111
1000000001
100000C001
1000000001
1000000001
1000E0C001
1000000001
1000000001
1000000001
10000P0001
1000000001
100E000001
1111111111